0.008
RN RN RN RN DN DN DN DN
RN RN RN RN DN DN DN DN
RN RN RN RN DN DN DN DN
RN RN RN RN RN UN UN UN
RN RN RN RN DN DN DN DN
RN RN RN RN DN DN DN DN
RN RN RN RN DN DN DN DN
RN RN RN RN UN UN UN UN
RS RN RN RN RF RN RN RN
RN UN LN DN RN UN LN DN
RN RN RN RN UN UN UN UN
RN RN RN RN UN UN UN UN
RN RN RN RN UN UN UN UN
RN RN RN RN UN UN UN UN